C:/omg_data/audio/train/Subject_10_Story_2.wav	C:/omg_data/annotations/train/Subject_10_Story_2.csv
C:/omg_data/audio/train/Subject_10_Story_4.wav	C:/omg_data/annotations/train/Subject_10_Story_4.csv
C:/omg_data/audio/train/Subject_10_Story_5.wav	C:/omg_data/annotations/train/Subject_10_Story_5.csv
C:/omg_data/audio/train/Subject_10_Story_8.wav	C:/omg_data/annotations/train/Subject_10_Story_8.csv
C:/omg_data/audio/train/Subject_1_Story_2.wav	C:/omg_data/annotations/train/Subject_1_Story_2.csv
C:/omg_data/audio/train/Subject_1_Story_4.wav	C:/omg_data/annotations/train/Subject_1_Story_4.csv
C:/omg_data/audio/train/Subject_1_Story_5.wav	C:/omg_data/annotations/train/Subject_1_Story_5.csv
C:/omg_data/audio/train/Subject_1_Story_8.wav	C:/omg_data/annotations/train/Subject_1_Story_8.csv
C:/omg_data/audio/train/Subject_2_Story_2.wav	C:/omg_data/annotations/train/Subject_2_Story_2.csv
C:/omg_data/audio/train/Subject_2_Story_4.wav	C:/omg_data/annotations/train/Subject_2_Story_4.csv
C:/omg_data/audio/train/Subject_2_Story_5.wav	C:/omg_data/annotations/train/Subject_2_Story_5.csv
C:/omg_data/audio/train/Subject_2_Story_8.wav	C:/omg_data/annotations/train/Subject_2_Story_8.csv
C:/omg_data/audio/train/Subject_3_Story_2.wav	C:/omg_data/annotations/train/Subject_3_Story_2.csv
C:/omg_data/audio/train/Subject_3_Story_4.wav	C:/omg_data/annotations/train/Subject_3_Story_4.csv
C:/omg_data/audio/train/Subject_3_Story_5.wav	C:/omg_data/annotations/train/Subject_3_Story_5.csv
C:/omg_data/audio/train/Subject_3_Story_8.wav	C:/omg_data/annotations/train/Subject_3_Story_8.csv
C:/omg_data/audio/train/Subject_4_Story_2.wav	C:/omg_data/annotations/train/Subject_4_Story_2.csv
C:/omg_data/audio/train/Subject_4_Story_4.wav	C:/omg_data/annotations/train/Subject_4_Story_4.csv
C:/omg_data/audio/train/Subject_4_Story_5.wav	C:/omg_data/annotations/train/Subject_4_Story_5.csv
C:/omg_data/audio/train/Subject_4_Story_8.wav	C:/omg_data/annotations/train/Subject_4_Story_8.csv
C:/omg_data/audio/train/Subject_5_Story_2.wav	C:/omg_data/annotations/train/Subject_5_Story_2.csv
C:/omg_data/audio/train/Subject_5_Story_4.wav	C:/omg_data/annotations/train/Subject_5_Story_4.csv
C:/omg_data/audio/train/Subject_5_Story_5.wav	C:/omg_data/annotations/train/Subject_5_Story_5.csv
C:/omg_data/audio/train/Subject_5_Story_8.wav	C:/omg_data/annotations/train/Subject_5_Story_8.csv
C:/omg_data/audio/train/Subject_6_Story_2.wav	C:/omg_data/annotations/train/Subject_6_Story_2.csv
C:/omg_data/audio/train/Subject_6_Story_4.wav	C:/omg_data/annotations/train/Subject_6_Story_4.csv
C:/omg_data/audio/train/Subject_6_Story_5.wav	C:/omg_data/annotations/train/Subject_6_Story_5.csv
C:/omg_data/audio/train/Subject_6_Story_8.wav	C:/omg_data/annotations/train/Subject_6_Story_8.csv
C:/omg_data/audio/train/Subject_7_Story_2.wav	C:/omg_data/annotations/train/Subject_7_Story_2.csv
C:/omg_data/audio/train/Subject_7_Story_4.wav	C:/omg_data/annotations/train/Subject_7_Story_4.csv
C:/omg_data/audio/train/Subject_7_Story_5.wav	C:/omg_data/annotations/train/Subject_7_Story_5.csv
C:/omg_data/audio/train/Subject_7_Story_8.wav	C:/omg_data/annotations/train/Subject_7_Story_8.csv
C:/omg_data/audio/train/Subject_8_Story_2.wav	C:/omg_data/annotations/train/Subject_8_Story_2.csv
C:/omg_data/audio/train/Subject_8_Story_4.wav	C:/omg_data/annotations/train/Subject_8_Story_4.csv
C:/omg_data/audio/train/Subject_8_Story_5.wav	C:/omg_data/annotations/train/Subject_8_Story_5.csv
C:/omg_data/audio/train/Subject_8_Story_8.wav	C:/omg_data/annotations/train/Subject_8_Story_8.csv
C:/omg_data/audio/train/Subject_9_Story_2.wav	C:/omg_data/annotations/train/Subject_9_Story_2.csv
C:/omg_data/audio/train/Subject_9_Story_4.wav	C:/omg_data/annotations/train/Subject_9_Story_4.csv
C:/omg_data/audio/train/Subject_9_Story_5.wav	C:/omg_data/annotations/train/Subject_9_Story_5.csv
C:/omg_data/audio/train/Subject_9_Story_8.wav	C:/omg_data/annotations/train/Subject_9_Story_8.csv
